1 0 0 0 0 0 0 0 0 0 0 0 1 0 0 0 0 0 0 0 0 0 0 0 0 0 0 0 0 1
1 0 0 0 0 0 0 0 0 0 0 0 1 0 0 0 0 0 0 0 0 0 0 0 0 0 0 0 0 1
1 0 0 0 0 0 0 0 0 0 0 0 1 0 8 0 0 0 0 0 0 0 0 0 0 0 0 0 0 1
1 0 0 0 0 9 0 0 0 0 0 0 1 1 1 0 1 0 0 0 0 0 0 0 2 0 0 0 0 1
1 0 0 0 0 1 0 0 0 0 0 0 0 0 1 0 1 0 0 0 0 0 0 0 0 0 2 0 0 1
1 0 0 0 0 1 0 0 0 0 0 0 0 0 1 0 1 3 0 0 0 0 9 0 0 0 0 0 0 1
1 0 0 0 0 1 0 0 0 3 0 0 0 0 1 0 1 0 0 0 0 0 0 0 0 0 0 0 2 1
1 0 0 0 0 9 0 0 0 1 0 0 0 0 0 0 1 0 0 0 0 0 0 0 0 0 0 0 0 1
1 0 0 0 0 0 0 0 0 1 3 0 0 0 0 0 1 0 3 0 0 9 0 0 0 0 2 0 0 1
1 0 0 0 0 1 0 0 0 1 0 0 0 0 9 0 1 0 0 0 0 0 0 0 0 0 0 0 0 1
1 0 0 0 0 1 0 0 0 1 0 0 0 0 1 0 1 0 0 0 0 0 0 0 0 0 0 0 2 1
1 0 0 0 0 1 0 0 0 1 0 0 0 0 1 0 1 0 0 0 3 0 0 0 0 0 0 0 0 1
1 0 0 0 0 1 0 0 0 1 3 0 0 0 1 0 1 0 0 0 0 0 0 0 0 0 2 0 0 1
1 4 4 4 4 1 0 0 0 1 0 0 0 0 0 0 1 0 0 0 0 0 0 0 0 0 0 0 0 1
1 0 0 0 0 9 0 0 0 1 0 0 0 0 0 0 1 9 0 0 0 0 0 0 0 0 0 0 2 1
1 9 0 0 0 0 0 0 0 1 0 0 0 0 9 0 1 0 0 0 0 0 0 0 0 0 0 0 0 1
1 2 0 2 0 2 0 0 0 1 3 0 0 0 1 0 1 2 0 0 2 0 0 2 0 0 2 0 0 1
1 4 4 4 4 4 4 4 4 4 4 4 4 4 4 4 4 4 4 4 4 4 4 4 4 4 4 4 4 1